border_size=1
usage=map

Ss          , Gg          , Gg          , Ss          , Ss          , Gs^Fp       , Gg          , Re          , Gs^Fp       , Gg          , Gs^Fp       , Gs^Fp       , Gg          , Ww          , Ww          , Wo          , Wo          , Ww          , Re          , Gg          , Gs^Fp       , Gs^Fp       , Gs^Fp       , Gs^Fp       , Gg          , Gg          , Hh^Fp       , Hh^Fp       , Hh^Fp       , Hh^Fp       , Hh^Fp       , Mm          , Mm          , Mm          
Ss          , Ss          , Gg          , Ss          , Ss          , Gs^Fp       , Gs^Fp       , Re          , Re          , Gg          , Gs^Fp       , Gg          , Gs^Fp       , Gs^Fp       , Ww          , Wo          , Wo^Bw/      , Ds^Bw/      , Re          , Re          , Re          , Gg          , Gg          , Gg          , Gg          , Hh^Fp       , Hh          , Hh^Fp       , Hh^Fp       , Hh^Fp       , Mm          , Mm          , Mm          , Mm          
Ss          , Ss          , Ss          , Ss          , Ss          , Gs^Fp       , Gs^Fp       , Gs^Fp       , Gs^Fp       , Re          , Re          , Gs^Fp       , Gs^Fp       , Gg          , Wwf^Bw/     , Wo^Bw/      , Wo          , Ds          , Gg          , Gg          , Gg          , Re          , Re          , Gg          , Gg          , Hh^Fp       , Hh          , Hh          , 2 Ke        , Mm          , Mm          , Hh^Fp       , Hh^Fp       , Mm          
Gs^Fp       , Gs^Fp       , Gs^Fp       , Ss          , Ss          , Gs^Fp       , Gs^Fp       , Gs^Fp       , Gs^Fp       , Re          , Re          , Re          , Re          , Re          , Ww          , Wo          , Wo          , Ww          , Gg          , Gg          , Gg          , Ggf         , Gg          , Re          , Gg          , Hh^Fp       , Hh^Fp       , Hh          , Ce          , Ce          , Hh          , Hh^Fp       , Hh^Fp       , Hh^Fp       
Re^Gvs      , Re^Gvs      , Re^Gvs      , Gs^Fp       , Gs^Fp       , Gs^Fp       , Gs^Fp       , Gg^Vo       , Gs^Fp       , Re          , Gg          , Gg          , Gg          , Hh          , Ww          , Wo          , Gg          , Gg          , Gg          , Gg          , Gg          , Ggf         , Gg          , Re          , Re          , Re          , Re          , Re          , Hh^Vo       , Ce          , Hh^Fp       , Hh^Fp       , Hh^Fp       , Hh^Fp       
Re^Gvs      , Re^Gvs      , Re^Gvs      , Re^Gvs      , Re^Gvs      , Gs^Fp       , Gs^Fp       , Gs^Fp       , Gs^Fp       , Re          , Gg          , Gg          , Gg          , Hh          , Mm          , Ww          , Ww          , Gg          , Gg          , Gg          , Gg          , Gg          , Gg          , Gg          , Gg          , Hh^Fp       , Hh^Fp       , Hh          , Hh          , Ce          , Hh^Fp       , Hh^Fp       , Hh^Fp       , Hh^Fp       
Re^Gvs      , Re^Gvs      , Re^Gvs      , Re^Gvs      , Gs^Fp       , Gg          , Gs^Fp       , Gs^Fp       , Gg          , Re          , Gg          , Gg          , Gg          , Gg          , Mm          , Hh          , Wwf         , Ww          , Gg          , Gg          , Gg          , Ggf         , Gg          , Gg          , Ggf         , Ggf         , Hh          , Hh          , Hh          , Hh          , Hh          , Hh^Fp       , Hh^Fp       , Hh^Fp       
Re^Gvs      , Re^Gvs      , Gg          , Gg          , Gg          , Hh          , Gg          , Gg          , Re          , Re          , Gg          , Hh          , Hh          , Gg          , Mm          , Mm          , Ww          , Gg          , Gg          , Ggf         , Gg          , Gg          , Gg          , Gg          , Gg          , Hh^Fp       , Hh          , Hh^Fp       , Gg          , Gg          , Gg          , Hh          , Hh          , Hh^Fp       
Gg          , Gg          , Gg          , Hh          , Mm          , Mm          , Hh          , Gg          , Re          , Hh          , Hh          , Hh          , Mm          , Hh          , Mm          , Wo          , Ww          , Gg          , Gg          , Gg          , Ggf         , Ggf         , Re^Gvs      , Re^Gvs      , Re^Gvs      , Hh^Fp       , Hh          , Hh          , Hh^Fp       , Gg          , Gg          , Hh          , Gg          , Gg          
Aa          , Gg          , Gg          , Mm          , Mm          , Mm          , Hh          , Gg          , Gg          , Re          , Hh          , Hh          , Mm          , Mm          , Mm          , Mm          , Hh          , Hh          , Gg          , Gg          , Re^Gvs      , Re^Gvs      , Re^Gvs      , Re^Gvs      , Re^Gvs      , Re^Gvs      , Re^Gvs      , Hh^Fp       , Gs^Fp       , Gg          , Gg          , Gg          , Re          , Gg          
Gg          , Gg          , Hh          , Mm          , Mm          , Mm          , Hh          , Gg          , Gg          , Re          , Re          , Hh          , Hh          , Mm          , Mm          , Mm          , Hh          , Hh          , Re^Gvs      , Re^Gvs      , Re^Gvs      , Re^Gvs      , Re^Gvs      , Re^Gvs      , Re^Gvs      , Re^Gvs      , Gg          , Gg          , Gg          , Gg          , Gg          , Gg          , Re          , Gg          
Gg          , Gg          , Hh          , Mm          , Mm          , Mm          , Gg          , Gg          , Gg          , Gg          , Re          , Gg          , Hh          , Hh          , Mm          , Mm          , Hh          , Hh          , Gg          , Re^Gvs      , Re^Gvs      , Re^Gvs      , Re^Gvs      , Re^Gvs      , Gg          , Gg          , Gg^Vo       , Gg          , Gg          , Gg          , Gg          , Gg          , Re          , Re          
Gg          , Gg          , Gg          , Hh          , Hh          , Hh          , Gg          , Gg          , Gg          , Gg          , Gg          , Re          , Gg          , Hh          , Hh          , Mm          , Mm          , Hh          , Hh^Vo       , Gg          , Gg          , Re^Gvs      , Gg          , Gg          , Gg          , Gg          , Re          , Gg          , Gg          , Gg          , Gg          , Gg          , Re          , Gg          
Ch          , Gg          , Gg          , Gg          , Gg          , Gs^Fp       , Re^Gvs      , Re^Gvs      , Re^Gvs      , Gg          , Gg          , Re          , Gg          , Gg          , Hh          , Mm          , Mm          , Mm          , Re          , Gg          , Re          , Re          , Re          , Re          , Re          , Re          , Gg          , Gg          , Gg          , Gg          , Gg          , Gg          , Re          , Gg          
Ch          , Ch          , Ch          , Gg          , Re^Gvs      , Re^Gvs      , Re^Gvs      , Re^Gvs      , Re^Gvs      , Re^Gvs      , Gg          , Re          , Rd          , Gg          , Gg          , Mm          , Hh          , Re          , Gg          , Gg          , Gg          , Ggf         , Gg          , Gg          , Gg          , Re          , Gg          , Gg          , Gg          , Gg          , Re          , Re          , Gg          , Hh          
Rr          , Ch          , Ch          , Ch          , Ch          , Re^Gvs      , Re^Gvs      , Re^Gvs      , Gg          , Gs^Fp       , Rd          , Rd          , Gg          , Re          , Re          , Re          , Mm          , Mm          , Hh          , Gg          , Gg          , Gg          , Gg          , Gg          , Gg          , Re          , Re          , Gg          , Re          , Re          , Gg          , Gg          , Gg          , Hh          
Rr          , Kh          , Rr          , Ch          , Ch          , Ch          , Ch          , Ggf         , Rd          , Rd          , Gg^Vo       , Gs^Fp       , Gg          , Gg          , Gg          , Gs^Fp       , Hh          , Mm          , Mm          , Hh          , Hh          , Gs^Fp       , Gs^Fp       , Gs^Fp       , Gg          , Gg          , Gg          , Re          , Gg          , Gg          , Gg          , Gg          , Gg          , Hh          
Rr          , Rr          , Rr          , Rr          , Rr          , Ch          , Ch          , Ch          , Ggf         , Gs^Fp       , Gs^Fp       , Gs^Fp       , Gg          , Gg          , Gg          , Hh          , Mm          , Mm          , Mm          , Hh          , Hh          , Gs^Fp       , Gs^Fp       , Gs^Fp       , Gs^Fp       , Gg          , Re          , Re          , Gg          , Gs^Fp       , Gg          , Gg          , Gg          , Hh          
Rr          , Rp^Vhc      , Rr          , Rr          , Rr          , 1 Kh        , Ch          , Ch          , Ch          , Gs^Fp       , Hh          , Gs^Fp       , Gs^Fp       , Gs^Fp       , Hh          , Hh          , Mm          , Mm          , Hh          , Hh          , Gg          , Gs^Fp       , Gs^Fp       , Gs^Fp       , Gs^Fp       , Re          , Gg          , Gg          , Gs^Fp       , Gs^Fp       , Gs^Fp       , Gs^Fp       , Gs^Fp       , Gs^Fp       
Kh          , Rr          , Rr          , Rr          , Rr          , Rr          , Rp          , Ch          , Ch          , Hh          , Hh          , Hh          , Hh          , Hh^Fp       , Hh          , Hh          , Mm          , Mm          , Mm          , Gg          , Gg          , Gg          , Gs^Fp       , Gs^Fp       , Re          , Re          , Gg          , Gg          , Gs^Fp       , Ds          , Gs^Fp       , Gs^Fp       , Gs^Fp       , Gs^Fp       
Kh          , Kh          , Kh          , Rp          , Rp          , Rp          , Hh          , Kh          , Ch          , Ch          , Hh^Fms      , Hh          , Hh          , Gg          , Mm          , Mm          , Mm          , Mm          , Mm          , Gg          , Gg          , Gg          , Gs^Fp       , Re          , Gg          , Gg          , Gg          , Ds          , Ds          , Ds          , Ds          , Gs^Fp       , Gs^Fp       , Gs^Fp       
Kh          , Kh          , Kh          , Kh          , Rp          , Rp          , Hh          , Hh^Fms      , Ch          , Ch          , Ch          , Mm          , Mm          , Mm          , Mm          , Mm          , Mm          , Mm          , Mm          , Mm          , Re          , Re          , Re          , Re          , Gg          , Gg          , Ds          , Ds          , Ds          , Ds          , Ds          , Ds          , Ds          , Gs^Fp       
